10 10
+--------+
|########|
|########|
|########|
|########|
|########|
|########|
|########|
|########|
t--------t