12 10
+----+-----+
|####|#####|
|####|#####|
|####|#####|
|####|#####|
|####t--d--+
|##########|
|##########|
|##########|
t----------t