12 10
+----+-----+
|####|#####|
|####|#####|
|####|#####|
|####|#####|
|####t--d--+
|##########|
|##s####b###
|####w#####|
t----------t