24 12
+----------------------+
|######################|
|######################|
+---------------------d|
|b#####################|
|##########s###########|
|d---------------------+
|##########s###########|
|b####################b|
+---------------------d|
|#f###f####f####f###fb#|
t----------------------t