12 10
+----+-----+
|####|#####|
|####|#####|
|####|#####|
|####|#####|
|####t--d--+
|##########t
|##s####b###
|####w#####+
t----------t