24 12
+----------------------+
|####################r#|
|######################|
|#####-----------------+
|##+###################|
|##|###################|
|##|###########b#######|
|##|###################|
|##|###################|
|r#|###################|
|##|###################|
t--+-------------------t