24 12
+----------------------+
|####################r#|
|######################|
|#####-----------------+
|##+##################w|
|##|###################|
|##|##############b####|
|##|#########s#########|
|##|###################|
|r#|######b#######r####|
|##|w##################|
t--t-------------------t