24 12
+----------------------+
|######################|
|######################|
|######################|
|######################|
|######################|
|##############b#######|
|######################|
|######################|
|######################|
|######################|
t----------------------t