12 10
+----+-----+
|####|#####|
|####|#####|
|####|#####|
|####|#####|
|####t--d--+
t##########|
########r##|
+##########|
t----------t