24 12
+----------------------+
|#####################w|
|######################|
|######################|
|#####################f|
|######################|
|##############b#######|
|w###f#############f##w|
+-----------d----------+
|fs######b#######b##r##|
|fs#b##b#r##b##b###b###|
t----------------------t