24 12
+----------------------+
|######################|
|######################|
|######################|
|######################|
|######################|
|##############b#######|
|######################|
+-----------d----------+
|########b#######b#####|
|###b##b#r##b##b###b###|
t----------------------t