24 12
+--+-------------+-----+
|##|f###########f|#####|
|##|#######r#####|#####|
|##|##+##########|##+##|
|##|##|f########f|r#|##|
|##|##+----d-----+##|##|
|##|##|s########s|##|##|
|##|##|s#r##r##rs|##|#r|
|##t##|----d-----t##|##|
|#####|#############|##|
|#####|f###########f|##|
t-----t-------------t--t