24 12
+--+-------------+-----+
|##|#############|#####|
|##|#############|#####|
|##|##+##########|##+##|
|##|##|##########|r#|##|
|##|##+----d-----+##|##|
|##|##|##########|##|##|
|##|##|##r##r##r#|##|#r|
|##t##|----d-----t##|##|
|#####|#############|##|
|#####|#############|##|
t-----t-------------t--t