24 12
+--+-------------------+
|##|###################|
|##|-t#+-------------t#|
|##|b##|##r####b#######|
|##+-+#+-------------t#|
|##tbt#|##r####r#######|
|######+-------------t#|
+------t###############|
|################+-----+
|##b###b######b##t#####|
|######################|
t----------------------t