24 12
+--+-------------------+
|##|f##################|
|##|-t#+-------------t#|
|##|b##|w#r####b#######|
|##+-+#+-------------t#|
|##tbt#|w#r####r#######|
|######+-------------t#|
+------t###############|
|f###############+-----+
|##b###b######b##t####f|
|f#####################|
t----------------------t