24 12
+---+---+---+---+------+
|###|sss|www|sss|f####f|
|###|###|###|###|######|
|###|###|###|###|###+##|
|###|###|###|###|###|##|
|###|###|###|###|###|##|
|###|###|###|###|###|##|
|###|rrr|bbb|rrr|###|##|
|###t###t###tbbbt###|##|
|###################|rr|
|f########f########f|##|
t-------------------t--t