24 12
+---+---+---+---+------+
|###|###|###|###|######|
|###|###|###|###|######|
|###|###|###|###|###+##|
|###|###|###|###|###|##|
|###|###|###|###|###|##|
|###|###|###|###|###|##|
|###|rrr|bbb|rrr|###|##|
|###t###t###tbbbt###|##|
|###################|rr|
|###################|##|
t-------------------t--t