24 12
+----------------------+
|#################r###f|
|##############r####r#f|
+--------------------d-+
|fb#############r#####s|
|f#####r###########b###|
+-d--------------------+
|s#####b##########r####|
|f####r##########b####f|
+----------d-----------+
|s###b#############br##|
t----------------------t