24 12
+----------------------+
|#################r####|
|##############r####r##|
+--------------------d-+
|#b#############r######|
|######r###########b###|
+-d--------------------+
|######b##########r####|
|#####r##########b#####|
+----------d-----------+
|####b#############br##|
t----------------------t