24 12
+----------------------+
|######################|
|----------+#+--+------|
|s########f|#|##|f#ss#f|
|###s##+----d---+######|
|######|#r#b##b#|######|
|##s###|#b#wwb#r|######|
|######|r##b##b#|###r##|
|#s####t---d----t#####b|
|####s####|########b###|
|f######sf|f####r######|
t---------t------------t