24 12
+----------------------+
|######################|
|----------+#+--+------|
|##########|#|##|######|
|######+----d---+######|
|######|#r#b##b#|######|
|######|#b##b##r|######|
|######|r##b##b#|###r##|
|######t---d----t#####b|
|#########|########b###|
|#########|#####r######|
t---------t------------t