24 12
+----------------------+
|######################|
|######################|
|#######b#####b########|
|#######b#####b########|
|#######b#####b########|
|#######b#####b########|
|####r###########r#####|
|#####rr#######rr###+--|
|#######rrrrrrr#####|##|
|###################|##|
t-------------------t--t