24 12
+----------------------+
|#####################f|
|#####################f|
|#######b#####b#######f|
|#######b#####b#######f|
|#######b#####b#######f|
|#######b#####b#######f|
|####r###########r#ffff|
|#####rr#######rr##f+--|
|#######rrrrrrr####f|sw|
|fffffffffffffffffff|s#|
t-------------------t--t